================PART 5=====================

among + N số nhiều
like: như là = such as
above: phía bên trên
under: phía bên dưới

before = prior to = by = in advance of = ahead of + N/cụm N; Ving...
before + SV
by + thời gian: trước khi
by + N/cụm N: bởi
by + Ving: bằng cách
by + phần trăm
by + phương tiện
by + địa điểm: bên cạnh

mạo từ + N/cụm N
giới từ + N/cụm N
giới từ + Ving + N/cụm N
trừ: to + Vo: để

ADV -> có đuôi ly -> bỏ ly -> ADJ  

balcony(n): ban công
stunning(adj): tuyệt đẹp

N's + N/cụm N
 -> sở hữu cách
 -> cái gì đó của ai đó
agent(n): nhân viên = staff = employee = personnel = associate = worker
extent(n): sự mở rộng, kéo dài
awareness(n): sự hiểu biết
proposal(n): bản đề xuất -> propose(v): đề xuất 
as soon as + SV: ngay khi
 
After/  + Ving + N/cụm N
Before  + S + V
        + N/cụm N	

after = following

vehicle = car = auto = automobile = sedan

expert = professional(n): chuyên gia
convince: thuyết phục
anticipate: kì vọng
accompanied by: đi kèm, đính kèm
caution: cẩn trọng

participate = take part in = join = involve = engage = attend: tham gia
 
N1 and N2
N1 or N2

S + V and S + V
S + V or S + V

ADJ and/or ADJ

appraise(v): thẩm định/ đánh giá

V + al -> Noun
appraise + al -> appraisal(n): sự thẩm định
arrive + al -> arrival(n): sự đến
propose + al -> proposal(n): bản đề xuất
renew + al -> renewal(n): sự gia hạn

responsible for: chịu trách nhiệm

site = place = location = venue(n): địa điểm
partially: một phần

except (for) + N/cụm N: trừ/ngoại từ = apart from
despite = in spite of + N/cụm N: mặc dù
elsewhere: nơi khác
past: vừa qua

key: quan trọng

S + V + so that + SV : để mà... 
 
term(n): điều khoản 

quite = rather + ADJ: tương đối, khá

energetic: đầy năng lượng
frequent = regular: thường xuyên
straightforward: dễ hiểu, rõ ràng
accomplish = achievement: đạt được, thành tựu
legal: pháp lý

material(n): tài liệu, vật liệu
solicit = feedback: xin phản hồi, xin ý kiến
outline: đưa ra ý chính, phát thảo ý chính

whichever: bất cứ cái nào + SV

merchandise = goods = items = supply(n) = commodity(n) : mặt hàng/ hàng hóa


ADV + Ving
    + Ved

substance(n): hợp chat

rush hour = peak hour: giờ cao điểm

such as: ví dụ
unless = if... not
thereby + Ving: do đó

by the time + S + V hiện tại -> vế còn lại S + V tương lai hoàn thành(will have + V3/ed)

by the time + S + V quá khứ -> vế còn lại S + V quá khứ hoàn thành(had + V3/ed)

demolish: phá hủy  

premise: cơ sở
defect = error = fault = malfunction: lỗi, hư hỏng
impact: tác động
distraction(n): sự sao nhãng


================PART 6=====================

destination(n): điểm đến
waves(v): song
water slides: ván trượt nước
companion(n): người bạn đồng hành
a fraction of the price: 1 phần giá(giá được giảm)

review(n): đánh giá
inquiry(n): câu hỏi

over/within/for/in/during/throughtou + thời gian/khoảng thời gian

quote = cost estimate: ước tính chi phí

stop by = drop by = visit: ghé qua

telemarketer: chuyên viên tư vấn qua điện thoại
sales lead(n): danh sách khách hàng tiềm năng

potential = prospective(adj): tiềm năng
loyal customer/client: khách hàng trung thành
valued customer: khách hàng thân thiết
optimal(adj): tối ưu

substantial = dramatic = significant = considerable = remarkable = noticeable(adj): đáng kể

insurance(n): bảo hiểm
telecommunication: viễn thông
transportation: vận tải

persuade(v): thuyết phục 
crucial(adj): rất quan trọng

actually: thực ra
however: tuy nhiên
additionally: ngoài ra
therefore: do đó

eligible for sth = qualified fo sth
eligible to do sth = qualified to do sth -> đủ điều kiện/ đủ năng lực

you feel(that) + S + V

meet = satisfy = accommodate: đáp ứng

Executive: ban quản trị

reimbursement = refund(n): hoàn tiền

pay out of pocket: thanh toán băng tiền túi

receipt = bill = invoice = statement: biên lai

further = extra = additional(adj): thêm