regret: hối tiếc
will + V0
have to + v0 = must: phải
vulnerability(n): lỗi
vulnerable to (adj): dễ bị tổn thương
discovered(v): phát hiện
therefore(adv): Do đó
Unforturnately(adv): không may
Regardless of: bất chấp, bất kể
Finally = Eventually  = Ultimately(adv): Cuối cùng
Process = procedure: Quá trình
Take + thời gian: Tốn
issuesd(v): phát hành --> issue(n): ấn phẩm, vấn đề
pick up: lấy --> pick sb up: đón
stop by: ghé qua
upon: khi
during: trong suốt(thời gian)
looking forward to + V-ing: trông đợi
seeking(v): tìm kiếm
instructor(n): người hướng dẫn

apply for a job: xin việc
application(n): đơn xin việc
applicants = candidate: ứng viên

versed: thành thạo

contemporary(adj): đương đại/hiện đại
unknown: ko biết / ko có danh tính
strang: lạ
boring: chán

giới từ + N/cụm N
giới từ + Ving + N/cụm N
trừ to + V0: để ...
be committed to + Ving: cam kết
look forward to + Ving: trông đợi
be accustomed to + Ving: quen với
be dedicated to + Ving: cống hiến

Peaceful: yên bình

offers: đưa ra
sustains: duy trì
maintain: duy trì -> maintain + N/cụm N
	  duy trì -> remain + ADJ	

culture(n): văn hóa

